........................................
........................................
...+--------------+.....................
...|..............|.....................
...|....................................
...|..............|.....................
..................|.....................
...|..............|.....................
...|..............|.....................
...|.........+----+.....................
...|.........|~~~~|.....................
...|.........|~~~~|.....................
...|.........|~~~~|.....................
...|..........~~~~|.....................
...|.........|~~~~|.....................
...|.........+----+...ok.boomer.........
...|..............|.....................
...|............+-+.....................
...|............|.......................
...+----.-------+.......................
